{
	"80": "\"",
	"81": "1",
	"82": "2",
	"83": "3",
	"84": "4",
	"85": "5",
	"86": "6",
	"87": "7",
	"88": "8",
	"89": "9",
	"23": "n",
	"28": "s",
	"36": "A",
	"40": "E",
	"44": "I",
	"50": "O",
	"56": "U",
	"64": "'",
	"71": ".",
	"72": ",",
	"73": "-",
	"75": "?",
	"76": "!",
	"78": ")",
	"79": "(",
	"96": " ",
	"37": "B",
	"38": "C",
	"39": "D",
	"41": "F",
	"42": "G",
	"43": "H",
	"45": "J",
	"46": "K",
	"47": "L",
	"48": "M",
	"49": "N",
	"51": "P",
	"52": "Q",
	"53": "R",
	"54": "S",
	"55": "T",
	"57": "V",
	"58": "W",
	"59": "X",
	"60": "Y",
	"61": "Z",
	"4": "a",
	"5": "b",
	"6": "c",
	"7": "d",
	"8": "e",
	"9": "f",
	"10": "g",
	"11": "h",
	"12": "i",
	"13": "j",
	"14": "k",
	"15": "l",
	"16": "m",
	"17": "n",
	"18": "o",
	"19": "p",
	"20": "q",
	"21": "r",
	"22": "s",
	"24": "t",
	"25": "u",
	"26": "v",
	"27": "w",
	"29": "x",
	"30": "y",
	"31": "z"
}
