{
  "80": "\"",
  "81": "1",
  "82": "2",
  "83": "3",
  "84": "4",
  "85": "5",
  "86": "6",
  "87": "7",
  "88": "8",
  "89": "9",
  "36": "A",
  "37": "B",
  "38": "C",
  "39": "D",
  "40": "E",
  "41": "F",
  "42": "G",
  "43": "H",
  "44": "I",
  "45": "J",
  "46": "K",
  "47": "L",
  "48": "M",
  "49": "N",
  "50": "O",
  "51": "P",
  "52": "Q",
  "53": "R",
  "54": "S",
  "55": "T",
  "56": "U",
  "57": "V",
  "58": "W",
  "59": "X",
  "60": "Y",
  "61": "Z",
  "4": "a",
  "5": "b",
  "6": "c",
  "7": "d",
  "8": "e",
  "9": "f",
  "10": "g",
  "11": "h",
  "12": "i",
  "13": "j",
  "14": "k",
  "15": "l",
  "16": "m",
  "17": "n",
  "18": "o",
  "19": "p",
  "20": "q",
  "21": "r",
  "22": "s",
  "23": "t",
  "24": "u",
  "25": "v",
  "26": "w",
  "27": "x",
  "28": "y",
  "29": "z",
  "64": "'",
  "71": ".",
  "72": ",",
  "73": "-",
  "75": "?",
  "76": "!",
  "78": ")",
  "79": "(",
  "96": " "
}